XXXXXXXXXXX
P   XXXXXXX
XXX XXXXXXX
XXX XXXXXXX
XXX XXXXXXX
XXX XXXXXXX
XXX XXXXXXX
X   XXXXXXX
X XXXXXXXXX
X         K
XXXXXXXXXXX
